█████████████████████████████
█                           █
█      $                    █
█                           █
█    ███████     ███████    █
█                           █
EH                          █
█►                         ◀︎█
█████████████████████████████